"filename", "language", "TOML", "Markdown", "Rust", "Slang", "JSON", "comment", "blank", "total"
"/home/andrew-peterson/code/laniusc/.cargo/config.toml", "TOML", 7, 0, 0, 0, 0, 3, 2, 12
"/home/andrew-peterson/code/laniusc/.rustfmt.toml", "TOML", 4, 0, 0, 0, 0, 7, 4, 15
"/home/andrew-peterson/code/laniusc/Cargo.lock", "TOML", 1590, 0, 0, 0, 0, 2, 194, 1786
"/home/andrew-peterson/code/laniusc/Cargo.toml", "TOML", 27, 0, 0, 0, 0, 0, 6, 33
"/home/andrew-peterson/code/laniusc/LEXING.md", "Markdown", 0, 69, 0, 0, 0, 0, 44, 113
"/home/andrew-peterson/code/laniusc/PARSING_PLAN.md", "Markdown", 0, 150, 0, 0, 0, 0, 72, 222
"/home/andrew-peterson/code/laniusc/README.md", "Markdown", 0, 26, 0, 0, 0, 0, 17, 43
"/home/andrew-peterson/code/laniusc/build.rs", "Rust", 0, 0, 168, 0, 0, 8, 24, 200
"/home/andrew-peterson/code/laniusc/lexer_tests/line_comment_eof.tokens.json", "JSON", 0, 0, 0, 0, 28, 0, 0, 28
"/home/andrew-peterson/code/laniusc/lexer_tests/operators_mix.tokens.json", "JSON", 0, 0, 0, 0, 100, 0, 0, 100
"/home/andrew-peterson/code/laniusc/lexer_tests/simple.tokens.json", "JSON", 0, 0, 0, 0, 56, 0, 0, 56
"/home/andrew-peterson/code/laniusc/lexer_tests/tricky_block_near_eof.tokens.json", "JSON", 0, 0, 0, 0, 24, 0, 0, 24
"/home/andrew-peterson/code/laniusc/shaders/lexer/apply_block_prefix_downsweep.slang", "Slang", 0, 0, 0, 83, 0, 6, 11, 100
"/home/andrew-peterson/code/laniusc/shaders/lexer/build_tokens.slang", "Slang", 0, 0, 0, 30, 0, 6, 8, 44
"/home/andrew-peterson/code/laniusc/shaders/lexer/compact_boundaries.slang", "Slang", 0, 0, 0, 85, 0, 8, 21, 114
"/home/andrew-peterson/code/laniusc/shaders/lexer/finalize_boundaries_and_seed.slang", "Slang", 0, 0, 0, 57, 0, 13, 19, 89
"/home/andrew-peterson/code/laniusc/shaders/lexer/retag_calls_and_arrays.slang", "Slang", 0, 0, 0, 71, 0, 14, 12, 97
"/home/andrew-peterson/code/laniusc/shaders/lexer/scan_block_summaries_inclusive.slang", "Slang", 0, 0, 0, 55, 0, 3, 8, 66
"/home/andrew-peterson/code/laniusc/shaders/lexer/scan_inblock_inclusive.slang", "Slang", 0, 0, 0, 81, 0, 6, 10, 97
"/home/andrew-peterson/code/laniusc/shaders/lexer/sum_apply_block_prefix_downsweep_pairs.slang", "Slang", 0, 0, 0, 53, 0, 5, 13, 71
"/home/andrew-peterson/code/laniusc/shaders/lexer/sum_inblock_pairs.slang", "Slang", 0, 0, 0, 51, 0, 8, 11, 70
"/home/andrew-peterson/code/laniusc/shaders/lexer/sum_scan_block_totals_inclusive.slang", "Slang", 0, 0, 0, 40, 0, 3, 6, 49
"/home/andrew-peterson/code/laniusc/shaders/lexer/utils.slang", "Slang", 0, 0, 0, 47, 0, 12, 12, 71
"/home/andrew-peterson/code/laniusc/shaders/reminders.md", "Markdown", 0, 78, 0, 0, 0, 0, 14, 92
"/home/andrew-peterson/code/laniusc/src/bin/fuzz_lex.rs", "Rust", 0, 0, 589, 0, 0, 3, 59, 651
"/home/andrew-peterson/code/laniusc/src/bin/gen_tables.rs", "Rust", 0, 0, 56, 0, 0, 5, 11, 72
"/home/andrew-peterson/code/laniusc/src/bin/perf_one.rs", "Rust", 0, 0, 230, 0, 0, 10, 30, 270
"/home/andrew-peterson/code/laniusc/src/lexer/cpu.rs", "Rust", 0, 0, 120, 0, 0, 11, 20, 151
"/home/andrew-peterson/code/laniusc/src/lexer/gpu/buffers.rs", "Rust", 0, 0, 226, 0, 0, 11, 38, 275
"/home/andrew-peterson/code/laniusc/src/lexer/gpu/debug.rs", "Rust", 0, 0, 62, 0, 0, 2, 13, 77
"/home/andrew-peterson/code/laniusc/src/lexer/gpu/mod.rs", "Rust", 0, 0, 394, 0, 0, 27, 55, 476
"/home/andrew-peterson/code/laniusc/src/lexer/gpu/passes/apply_block_prefix_downsweep.rs", "Rust", 0, 0, 64, 0, 0, 0, 7, 71
"/home/andrew-peterson/code/laniusc/src/lexer/gpu/passes/build_tokens.rs", "Rust", 0, 0, 64, 0, 0, 0, 6, 70
"/home/andrew-peterson/code/laniusc/src/lexer/gpu/passes/compact_boundaries_all.rs", "Rust", 0, 0, 79, 0, 0, 3, 9, 91
"/home/andrew-peterson/code/laniusc/src/lexer/gpu/passes/compact_boundaries_kept.rs", "Rust", 0, 0, 90, 0, 0, 2, 9, 101
"/home/andrew-peterson/code/laniusc/src/lexer/gpu/passes/finalize_boundaries_and_seed.rs", "Rust", 0, 0, 120, 0, 0, 0, 17, 137
"/home/andrew-peterson/code/laniusc/src/lexer/gpu/passes/mod.rs", "Rust", 0, 0, 298, 0, 0, 17, 35, 350
"/home/andrew-peterson/code/laniusc/src/lexer/gpu/passes/retag_calls_and_arrays.rs", "Rust", 0, 0, 62, 0, 0, 6, 8, 76
"/home/andrew-peterson/code/laniusc/src/lexer/gpu/passes/scan_block_summaries_inclusive.rs", "Rust", 0, 0, 154, 0, 0, 3, 20, 177
"/home/andrew-peterson/code/laniusc/src/lexer/gpu/passes/scan_inblock_inclusive_pass.rs", "Rust", 0, 0, 69, 0, 0, 0, 8, 77
"/home/andrew-peterson/code/laniusc/src/lexer/gpu/passes/sum_apply_block_prefix_downsweep_pairs.rs", "Rust", 0, 0, 52, 0, 0, 0, 7, 59
"/home/andrew-peterson/code/laniusc/src/lexer/gpu/passes/sum_inblock_pairs.rs", "Rust", 0, 0, 47, 0, 0, 1, 7, 55
"/home/andrew-peterson/code/laniusc/src/lexer/gpu/passes/sum_scan_block_totals_inclusive.rs", "Rust", 0, 0, 145, 0, 0, 2, 19, 166
"/home/andrew-peterson/code/laniusc/src/lexer/gpu/timer.rs", "Rust", 0, 0, 97, 0, 0, 3, 12, 112
"/home/andrew-peterson/code/laniusc/src/lexer/mod.rs", "Rust", 0, 0, 3, 0, 0, 1, 1, 5
"/home/andrew-peterson/code/laniusc/src/lexer/tables/build.rs", "Rust", 0, 0, 157, 0, 0, 11, 25, 193
"/home/andrew-peterson/code/laniusc/src/lexer/tables/compact.rs", "Rust", 0, 0, 59, 0, 0, 10, 12, 81
"/home/andrew-peterson/code/laniusc/src/lexer/tables/dfa.rs", "Rust", 0, 0, 269, 0, 0, 19, 35, 323
"/home/andrew-peterson/code/laniusc/src/lexer/tables/io.rs", "Rust", 0, 0, 186, 0, 0, 17, 27, 230
"/home/andrew-peterson/code/laniusc/src/lexer/tables/mod.rs", "Rust", 0, 0, 15, 0, 0, 4, 3, 22
"/home/andrew-peterson/code/laniusc/src/lexer/tables/tokens.rs", "Rust", 0, 0, 48, 0, 0, 10, 9, 67
"/home/andrew-peterson/code/laniusc/src/lib.rs", "Rust", 0, 0, 2, 0, 0, 0, 1, 3
"/home/andrew-peterson/code/laniusc/src/main.rs", "Rust", 0, 0, 20, 0, 0, 2, 4, 26
"/home/andrew-peterson/code/laniusc/src/reflection.rs", "Rust", 0, 0, 333, 0, 0, 19, 30, 382
"Total", "-", 1628, 323, 4278, 653, 208, 303, 1045, 8438